0,0,0,0,0,0,0,0,0,0,0,0,0,0,0,0,0,0,0,0,0,0,0,0,0
0,0,0,0,0,0,0,0,0,0,0,0,0,0,0,0,0,0,0,0,0,0,0,0,0
0,0,0,0,0,0,0,0,0,0,0,0,0,0,0,0,0,0,0,0,0,0,0,0,0
0,0,0,0,0,17,1,1,1,1,1,1,1,1,1,1,1,1,1,19,0,0,0,0,0
0,0,0,0,0,81,33,33,33,129,130,131,132,133,134,36,33,33,33,83,0,0,0,0,0
0,0,0,0,0,81,99,99,99,161,162,163,164,165,166,68,99,99,99,83,0,0,0,0,0
0,0,0,0,0,81,99,99,99,99,99,99,99,99,99,99,99,99,99,83,0,0,0,0,0
1,1,1,1,1,85,99,99,99,99,99,99,99,99,99,99,99,99,99,84,1,1,1,1,1
141,141,141,141,141,141,99,99,99,99,99,99,99,99,99,99,99,99,99,143,143,143,143,143,143
99,99,99,99,99,99,99,99,99,99,99,99,99,99,99,99,99,99,99,99,99,99,99,99,99
99,99,99,99,99,99,99,99,99,99,99,99,99,99,99,99,99,99,99,99,99,99,99,99,99
33,33,33,33,33,33,99,99,99,99,99,99,99,99,99,99,99,99,99,33,33,33,33,33,33
0,0,0,0,0,81,99,99,99,99,99,99,99,99,99,99,99,99,99,83,0,0,0,0,0
0,0,0,0,0,81,99,99,99,99,99,99,99,99,99,99,99,99,99,83,0,0,0,0,0
0,0,0,0,0,81,99,99,99,99,99,99,99,99,99,99,99,99,99,83,0,0,0,0,0
0,0,0,0,0,81,99,99,99,99,99,99,99,99,99,99,99,99,99,83,0,0,0,0,0
0,0,0,0,0,113,33,33,33,33,33,33,33,33,33,33,33,33,33,115,0,0,0,0,0
0,0,0,0,0,0,0,0,0,0,0,0,0,0,0,0,0,0,0,0,0,0,0,0,0
0,0,0,0,0,0,0,0,0,0,0,0,0,0,0,0,0,0,0,0,0,0,0,0,0
0,0,0,0,0,0,0,0,0,0,0,0,0,0,0,0,0,0,0,0,0,0,0,0,0